1111111111111
10010000000C1
1000000000011
1P0000000E111
1111111111111