111111111111111111111111111111111111111111111111111111111111111111111111111111111111
100000000000000000000000000000000000000000000000000000000000000000000000E00000000011
1001C0C0000C0C00000C0000000000011100000000000000000000000000000000000000000000000111
1001C0C0000C0C00000C0000000000011100000000000000000000000000000000000000000000000111
1001C0C0000C0C00000C0000000000011100000000000000000000000000000000000000000000000111
1001C0C0000C0C00000C0000000000011100000000000000000000000000000000000000000000000111
1001C0C0000C0C00000C0000000000011100000000000000000000000000000000000000000000000111
1001C0C0000C0C00000C0000000000011100000000000000000000000000000000000000000000000111
1001C0C0000C0C00000C0000000000011100000000000000000000000000000000000000000000000111
1001C0C0000C0C00000C0000000000011100000000000000000000000000000000000000000000000111
1001C0C0000C0C00000C0000000000011100000000000000000000000000000000000000000000000111
1001C0C0000C0C00000C0000000000011100000000000000000000000000000000000000000000000111
1001C0C0000C0C00000C0000000000011100000000000000000000000000000000000000000000000111
1001C0C0000C0C00000C0000000000011100000000000000000000000000000000000000000000000111
1001C0C0000C0C00000C0000000000011100000000000000000000000000000000000000000000000111
1001C0C0000C0C00000C0000000000011100000000000000000000000000000000000000000000000111
1001C0C0000C0C00000C0000000000011100000000000000000000000000000000000000000000000111
1001C0C0000C0C00000C0000000000011100000000000000000000000000000000000000000000000111
1001C0C0000C0C00000C0000000000011100000000000000000000000000000000000000000000000111
1001C0C0000C0C00000C0000000000011100000000000000000000000000000000000000000000000111
1001C0C0000C0C00000C0000000000011100000000000000000000000000000000000000000000000111
11111101001000001010010000C001010111111100111100000000000000000000000000000000000111
10000C0000C0000C00000C00000000000100101000100010000000000000000000000000000000000111
101001001010101000000100000001010111111111111111111111111111111111111111111111111111
1P0000000000000000000000000000000100000000000000000000000000000000000000000000000111
111111111111111111111111111111111111111111111111111111111111111111111111111111111111
