111111111111111111111111111111111111111111111111111
100000000000000000000000000000000000000000000000001
1001C0C0000C0C00000C0000000000011100000000000000001
1001C0C0000C0C00000C0000000000011100000000000000001
1001C0C0000C0C00000C0000000000011100000000000000001
1001C0C0000C0C00000C0000000000011100000000000000001
1001C0C0000C0C00000C0000000000011100000000000000001
1001C0C0000C0C00000C0000000000011100000000000000001
1001C0C0000C0C00000C00000000000111000000000000C0001
1001C0C0000C0C00000C0000000000011100000000000000001
1001C0C0000C0C00000C0000000000011100000000000000001
1001C0C0000C0C00000C0000000000011100000000000000001
1001C0C0000C0C00000C0000000000011100000000000000001
1001C0C0000C0C00000C0000000000011100000000000000001
1001C0C0000C0C00000C00000000000111000000000000E0001
1001C0C0000C0C00000C0000000000011100000000000000001
1001C0C0000C0C00000C0000000000011100000000000000001
1001C0C0000C0C00000C0000000000011100000000000000001
1001C0C0000C0C00000C0000000000011100000000000000001
1001C0C0000C0C00000C0000000000011100000000000000001
1001C0C0000C0C00000C0000000000011100000000000000001
11111101001000001010010000C001010111111100111100001
10000C0000C0000C00000C00000000000100101000100010001
101001001010101000000100000001010111111111111111101
1P0000000000000000000000000000000100000000000000001
111111111111111111111111111111111111111111111111111
111111111111111111111111111111111111111111111111111
111111111111111111111111111111111111111111111111111
