1111111111111111111111111111111111
1E00000111111110000000C00000C00011
1010010100100000101001000000010111
1010010010101010001001000101010111
1P0000000C00C0000001111111110000C1
1111111111111111111111111111111111