1111111111111111111111111111111111
1001C0C0000C0C00000C00000000000111
11111101001000001010010000C0010101
10000C0000C0000C00000C000000000001
101001010010000000E0000000C0101011
1010010010101010000001000000010101
1P00000000000000000000000000000001
1111111111111111111111111111111111