11111111111111111111111111111
1001C0C0000C0C00000C000000001
11111101001000001010010000C01
10000C0000C0000C00000C0000001
101001010010000000E0000000C01
10100100101010100000010000001
1P000000000000000000000000111
11111111111111111111111111111