111111111111111
11E000010C01101
100000000C00101
100P00010111101
100010101001101
111111111111111