1111111
1C10E01
1100001
1010011
111P111
1111111