1111111111111
11ECP00C0CC11
1111111111111
