1111111111111
11EP000000C11
1111111111111