11111111111
1E000C1C1C1
101C1C0CP01
10000000011
11111111111